2 2 3 3 4 4 5
3 2 5 3 2 4 4
5 5 6 4 6 2 3
4 2 5 5 3 3 2
5 5 6 6 4 6 3
6 5 2 4 3 3 4
2 4 3 6 4 2 5